15 8 3 2
..444..........
.........1..23.
.....4...4.....
..*+...1.....2.
....+.2.3...@..
.......4.....+.
.11*......1....
............2..
